24 6
************************
*G    *        S       *
******* ************** *
*       ************** *
*******                *
************************